1111111111
101P111C11
1111111111